year,date,confirm_add,confirm,heal,dead
2020,03.04,1,1,0,0
2020,03.05,0,1,0,0
2020,03.06,1,2,0,0
2020,03.07,6,8,0,0
2020,03.08,0,8,0,1
2020,03.09,4,12,0,1
2020,03.10,5,17,0,1
2020,03.11,2,19,0,1
2020,03.12,2,21,0,1
2020,03.13,10,31,0,1
2020,03.14,3,34,1,1
2020,03.15,11,45,1,2
2020,03.16,11,56,1,2
2020,03.17,9,65,1,2
2020,03.18,14,79,1,2
2020,03.19,18,97,3,2
2020,03.20,31,128,3,3
2020,03.21,30,158,3,3
2020,03.22,67,225,27,4
2020,03.23,40,265,27,4
2020,03.24,36,301,27,4
2020,03.25,84,385,27,6
2020,03.26,117,502,27,6
2020,03.27,87,589,27,12
2020,03.28,101,690,72,17
2020,03.29,55,745,72,19
2020,03.30,75,820,72,80
2020,03.31,146,966,228,26
2020,04.01,88,1054,248,27
2020,04.02,79,1133,248,34
2020,04.03,132,1265,256,39
2020,04.04,88,1353,266,42
2020,04.05,98,1451,279,44
2020,04.06,103,1554,280,48
2020,04.07,74,1628,338,55
2020,04.08,87,1715,338,62
2020,04.09,80,1795,358,70
2020,04.10,99,1894,365,79
2020,04.11,81,1975,440,83
2020,04.12,167,2142,468,90
2020,04.13,66,2208,468,97
2020,04.14,69,2277,559,101
2020,04.15,166,2443,596,109
2020,04.16,128,2571,631,115
2020,04.17,98,2669,666,122
2020,04.18,89,2758,685,129
2020,04.19,81,2839,709,132
2020,04.20,102,2941,737,136
2020,04.21,90,3031,840,145
2020,04.22,113,3144,872,152
2020,04.23,144,3288,919,159
2020,04.24,147,3435,976,167
2020,04.25,172,3607,1030,179
2020,04.26,173,3780,1107,187
2020,04.27,112,3892,1107,192
2020,04.28,111,4003,1140,197
2020,04.29,124,4127,1192,207
2020,04.30,158,4285,1192,214
2020,05.01,143,4428,1256,218
2020,05.02,104,4532,1320,229
2020,05.03,0,4532,1320,229
2020,05.04,251,4783,1354,246
2020,05.05,104,4887,1442,260
2020,05.06,133,5020,1524,264
2020,05.07,188,5208,1601,273
2020,05.08,163,5371,1601,282
2020,05.09,240,5611,1659,293
2020,05.10,165,5776,1757,300
2020,05.11,258,6034,1837,305
2020,05.12,244,6278,1837,317
2020,05.13,285,6563,2266,321
2020,05.14,316,6879,2385,344
2020,05.15,255,7134,2497,353
2020,05.16,345,7479,2534,363
2020,05.17,326,7805,2569,366
2020,05.18,263,8068,2625,374
2020,05.19,303,8371,2625,382
2020,05.20,438,8809,2933,394
2020,05.21,474,9283,2933,403
2020,05.22,648,9931,3032,416
2020,05.23,718,10649,3530,439
2020,05.24,704,11353,3530,445
2020,05.25,723,12076,3999,456
2020,05.26,552,12628,4167,471
2020,05.27,600,13228,4349,492
2020,05.28,705,13933,4349,501
2020,05.29,769,14702,4788,510
2020,05.30,717,15419,4788,520
2020,05.31,795,16214,5336,530
2020,06.01,637,16851,5521,541
2020,06.02,564,17415,5709,560
2020,06.03,904,18319,5709,569
2020,06.04,949,19268,5993,588
2020,06.05,929,20197,6088,615
2020,06.06,840,21037,6180,642
2020,06.07,983,22020,6909,656
2020,06.08,774,22794,7305,670
2020,06.09,826,23620,7568,698
2020,06.10,1141,24761,7568,717
2020,06.11,1226,25987,8332,741
2020,06.12,1386,27373,8743,772
2020,06.13,1391,28764,9083,802
2020,06.14,1531,30295,9564,819
2020,06.15,1282,31577,9891,842
2020,06.16,1208,32785,10174,862
2020,06.17,1374,34159,10512,886
2020,06.18,1393,35552,10721,929
2020,06.19,1958,37510,11851,954
2020,06.20,2060,39570,11851,979
2020,06.21,1634,41204,12728,1000
2020,06.22,1581,42785,13153,1016
2020,06.23,2146,44931,13153,1043
2020,06.24,2285,47216,13816,1085
2020,06.25,2635,49851,14788,1124
2020,06.26,2606,52457,18416,1167
2020,06.27,2886,55343,19143,1192
2020,06.28,2401,57744,20134,1217
2020,06.29,2189,59933,21138,1245
2020,06.30,2335,62268,21138,1280
2020,07.01,2262,64530,23040,1310
2020,07.02,2667,67197,24186,1363
2020,07.03,2744,69941,25224,1403
2020,07.04,2845,72786,25930,1453
2020,07.05,2590,75376,27597,1490
2020,07.06,2439,77815,28531,1523
2020,07.07,2632,80447,30095,1602
2020,07.08,2979,83426,36502,1654
2020,07.09,3604,87030,38313,1707
2020,07.10,3663,90693,38984,1749
2020,07.11,3367,94060,41408,1787
2020,07.12,3449,97509,41408,1810
2020,07.13,2657,100166,44173,1859
2020,07.14,3099,103265,45467,1926
2020,07.15,3645,106910,47298,1987
2020,07.16,4236,111146,47298,2050
2020,07.17,3637,114783,49780,2133
2020,07.18,4518,119301,52607,2204
2020,07.19,3223,122524,54105,2246
2020,07.20,4231,126755,54105,2260
2020,07.21,4019,130774,55913,2373
2020,07.22,5344,136118,60531,2506
2020,07.23,5782,141900,62815,2617
2020,07.24,6127,148027,65447,2722
2020,07.25,5493,153520,68022,2847
2020,07.26,4814,158334,68022,2893
2020,07.27,4192,162526,72575,2956
2020,07.28,4890,167416,75083,3082
2020,07.29,5939,173355,75083,3179
2020,07.30,5641,178996,80596,3311
2020,07.31,6377,185373,83780,3466
2020,08.01,5929,191302,86499,3558
2020,08.02,5241,196543,89026,3612
2020,08.03,5376,201919,91302,3667
2020,08.04,4824,206743,94129,3863
2020,08.05,6792,213535,96948,4009
2020,08.06,7147,220682,99852,4135
2020,08.07,7513,228195,99852,4251
2020,08.08,7482,235677,103297,4411
2020,08.09,6134,241811,108242,4556
2020,08.10,4688,246499,108242,4634
2020,08.11,7369,253868,181389,4785
2020,08.12,7043,260911,187283,5088
2020,08.13,7663,268574,192434,5246
2020,08.14,7498,276072,199005,5428
2020,08.15,6365,282437,205697,5565
2020,08.16,6663,289100,205697,5637
2020,08.17,5469,294569,211702,5703
2020,08.18,4557,299126,217850,5814
2020,08.19,6840,305966,228725,6114
2020,08.20,6693,312659,233651,6406
2020,08.21,8225,320884,239806,6567
2020,08.22,8159,329043,239806,6730
2020,08.23,7759,336802,251400,6947
2020,08.24,5352,342154,256789,7079
2020,08.25,8713,350867,256789,7366
2020,08.26,8771,359638,268801,7661
2020,08.27,10550,370188,274458,7944
2020,08.28,10104,380292,280165,8129
2020,08.29,11717,392009,287220,8305
2020,08.30,9230,401239,294007,8401
2020,08.31,7187,408426,301195,8498
2020,09.01,9309,417735,308376,8730
2020,09.02,10504,428239,315530,8971
2020,09.03,10933,439172,322461,9155
2020,09.04,12026,451198,331621,9468
2020,09.05,10684,461882,340381,9685
2020,09.06,9924,471806,349132,9807
2020,09.07,6986,478792,357388,9912
2020,09.08,9215,488007,366590,10179
2020,09.09,12027,500034,382490,10457
2020,09.10,12259,512293,390098,10713
2020,09.11,11905,524198,400121,10994
2020,09.12,11507,535705,409771,11206
2020,09.13,10776,546481,419513,11307
2020,09.14,9056,555537,419513,11412
2020,09.15,9909,565446,438883,11710
2020,09.16,11892,577338,448263,11910
2020,09.17,11674,589012,456347,12229
2020,09.18,12701,601713,467286,12491
2020,09.19,11945,613658,478077,12705
2020,09.20,9276,622934,488231,12909
2020,09.21,8431,631365,488231,13053
2020,09.22,8782,640147,508563,13482
2020,09.23,12027,652174,517228,13952
2020,09.24,12625,664799,525486,14376
2020,09.25,13467,678266,536589,14766
2020,09.26,12969,691235,546924,15208
2020,09.27,11249,702484,556489,15543
2020,09.28,8841,711325,565935,15749
2020,09.29,11807,723132,576715,16113
2020,09.30,13477,736609,585857,16519
2020,10.01,14392,751001,594645,16937
2020,10.02,14001,765002,603140,20288
2020,10.03,14687,779689,614515,20599
2020,10.04,11129,790818,626114,20795
2020,10.05,7668,798486,636672,21018
2020,10.06,11242,809728,649017,21468
2020,10.07,14740,824468,660272,21827
2020,10.08,16447,840915,670725,22226
2020,10.09,15454,856369,684844,22710
2020,10.10,15099,871468,697141,23225
2020,10.11,12414,883882,709464,23581
2020,10.12,10324,894206,721380,23868
2020,10.13,9524,903730,732582,24186
2020,10.14,13305,917035,742235,24572
2020,10.15,14932,931967,751146,24921
2020,10.16,17096,949063,764859,25342
2020,10.17,16546,965609,778501,25723
2020,10.18,13510,979119,791174,26107
2020,10.19,10561,989680,803965,26267
2020,10.20,12982,1002662,803965,26716
2020,10.21,16337,1018999,829647,27100
2020,10.22,18326,1037325,840520,27519
2020,10.23,16325,1053650,851854,27957
2020,10.24,15718,1069368,866695,28338
2020,10.25,11968,1081336,881113,28613
2020,10.26,9253,1090589,894819,28896
2020,10.27,11712,1102301,909586,29301
2020,10.28,14308,1116609,921344,29730
2020,10.29,13924,1130533,931147,30071
2020,10.30,13267,1143800,946134,30442
2020,10.31,13379,1157179,961101,30792
2020,11.01,9745,1166924,973939,31002
2020,11.02,6609,1173533,985316,31140
2020,11.03,9598,1183131,998016,31623
2020,11.04,12145,1195276,1009278,32052
2020,11.05,10652,1205928,1017647,32520
2020,11.06,11100,1217028,1030137,32766
2020,11.07,11786,1228814,1042237,33136
2020,11.08,8037,1236851,1053313,33348
2020,11.09,5331,1242182,1062911,33560
2020,11.10,8317,1250499,1073577,33907
2020,11.11,11977,1262476,1081897,34183
2020,11.12,10880,1273356,1081897,34531
2020,11.13,11163,1284519,1100180,34782
2020,11.14,11859,1296378,1110477,35045
2020,11.15,8468,1304846,1119366,35307
2020,11.16,5645,1310491,1129102,35436
2020,11.17,7893,1318384,1140196,35727
2020,11.18,10621,1329005,1148833,36106
2020,11.19,10332,1339337,1156474,36347
2020,11.20,10097,1349434,1167514,36532
2020,11.21,9608,1359042,1177819,36790
2020,11.22,7140,1366182,1187053,36902
2020,11.23,4184,1370366,1195492,37002
2020,11.24,4265,1374631,1203800,37122
2020,11.25,7164,1381795,1210634,37432
2020,11.26,8593,1390388,1217284,37714
2020,11.27,9043,1399431,1226662,37941
2020,11.28,7846,1407277,1235257,38216
2020,11.29,6098,1413375,1242877,38322
2020,11.30,5432,1418807,1249843,38473
2020,12.01,5726,1424533,1257227,38730
2020,12.02,8037,1432570,1263251,38928
2020,12.03,7533,1440103,1268358,39156
2020,12.04,7629,1447732,1274675,39305
2020,12.05,6899,1454631,1281955,39512
2020,12.06,5201,1459832,1288785,39632
2020,12.07,3278,1463110,1294692,39770
2020,12.08,3199,1466309,1300696,39888
2020,12.09,3610,1469919,1305587,40009
2020,12.10,5303,1475222,1311488,40222
2020,12.11,6994,1482216,1318187,40431
2020,12.12,7112,1489328,1324792,40606
2020,12.13,5274,1494602,1330160,40668
2020,12.14,3558,1498160,1335317,40766
2020,12.15,5062,1503222,1340120,41041
2020,12.16,6981,1510203,1344300,41204
2020,12.17,6843,1517046,1347914,41365
2020,12.18,7326,1524372,1352556,41534
2020,12.19,7002,1531374,1356755,41672
2020,12.20,5795,1537169,1362617,41763
2020,12.21,4116,1541285,1368346,41813
2020,12.22,5853,1547138,1374401,41997
2020,12.23,8141,1555279,1379726,42254
2020,12.24,8586,1563865,1384277,42314
2020,12.25,7815,1571680,1384277,42392
2020,12.26,2874,1574554,1384277,42422
2020,12.27,3713,1578267,1402227,42501
2020,12.28,5030,1583297,1407926,42650
2020,12.29,7216,1590513,1414680,42868
2020,12.30,11650,1602163,1420885,43018
2020,12.31,11765,1613928,1426676,43163
2021,01.01,11586,1625514,1426676,43245
2021,01.02,4080,1629594,1426676,43319
2021,01.03,5240,1634834,1447092,43375
2021,01.04,5884,1640718,1452960,43482
2021,01.05,8222,1648940,1458083,43634
2021,01.06,13790,1662730,1466616,43785
2021,01.07,13441,1676171,1474048,43976
2021,01.08,13835,1690006,1484794,44122
2021,01.09,13346,1703352,1494896,44273
2021,01.10,11057,1714409,1504330,44417
2021,01.11,7808,1722217,1511750,44495
2021,01.12,8704,1730921,1518715,44654
2021,01.13,13783,1744704,1527861,44848
2021,01.14,12725,1757429,1536423,44983
2021,01.15,13286,1770715,1549490,45125
2021,01.16,12332,1783047,1561963,45227
2021,01.17,8932,1791979,1573104,45295
2021,01.18,7264,1799243,1583465,45407
2021,01.19,8185,1807428,1594768,45832
2021,01.20,12141,1819569,1604373,46066
2021,01.21,12112,1831681,1613773,46216
2021,01.22,11396,1843077,1625755,46355
2021,01.23,10753,1853830,1636826,46575
2021,01.24,8362,1862192,1646668,46737
2021,01.25,5031,1867223,1656149,46827
2021,01.26,7578,1874801,1666527,47034
2021,01.27,10409,1885210,1674555,47253
2021,01.28,10843,1896053,1682563,47435
2021,01.29,9471,1905524,1693146,47601
2021,01.30,9838,1915362,1703459,47775
2021,01.31,6902,1922264,1712868,47931
2021,02.01,4975,1927239,1721650,47974
2021,02.02,6614,1933853,1729999,48249
2021,02.03,9695,1943548,1738768,48426
2021,02.04,9196,1952744,1745208,48539
2021,02.05,8891,1961635,1754705,48700
2021,02.06,8374,1970009,1763762,48985
2021,02.07,6680,1976689,1772059,49110
2021,02.08,3658,1980347,1778965,49171
2021,02.09,5154,1985501,1786178,49398
2021,02.10,7794,1993295,1792321,49566
2021,02.11,7739,2001034,1798120,49674
2021,02.12,7311,2008345,1806260,49874
2021,02.13,7151,2015496,1814160,50029
2021,02.14,6057,2021553,1820965,50188
2021,02.15,4245,2025798,1827118,50236
2021,02.16,3259,2029057,1833442,50327
2021,02.17,4003,2033060,1838291,50432
2021,02.18,6064,2039124,1842878,50616
2021,02.19,7671,2046795,1849451,50857
2021,02.20,7886,2054681,1855645,51000
2021,02.21,5944,2060625,1861433,51122
2021,02.22,3709,2064334,1866501,51198
2021,02.23,5417,2069751,1872213,51359
2021,02.24,7477,2077228,1877898,51510
2021,02.25,8183,2085411,1882568,51650
2021,02.26,8234,2093645,1886732,51795
2021,02.27,5083,2098728,1892834,51887
2021,02.28,5469,2104197,1899087,51946
2021,03.01,3168,2107365,1905021,51965
2021,03.02,4658,2112023,1911338,52077
2021,03.03,6653,2118676,1916936,52192
2021,03.04,7855,2126531,1921589,52453
2021,03.05,7432,2133963,1928377,52644
2021,03.06,7891,2141854,1934845,52784
2021,03.07,4860,2146714,1940317,52870
2021,03.08,2922,2149636,1945816,52880
2021,03.09,5058,2154694,1951540,53121
2021,03.10,7307,2162001,1956591,53252
2021,03.11,7693,2169694,1961640,53359
2021,03.12,8204,2177898,1968462,53493
2021,03.13,7849,2185747,1974866,53578
2021,03.14,6278,2192025,1981157,53646
2021,03.15,3697,2195722,1986903,53670
2021,03.16,6164,2201886,1993215,53836
2021,03.17,8235,2210121,1998594,54036
2021,03.18,8304,2218425,2003121,54231
2021,03.19,8328,2226753,2009877,54386
2021,03.20,8160,2234913,2016729,54476
2021,03.21,6826,2241739,2023664,54517
2021,03.22,4032,2245771,2030153,54545
2021,03.23,6401,2252172,2037686,54671
2021,03.24,9405,2261577,2043957,54823
2021,03.25,8300,2269877,2049035,54946
2021,03.26,8238,2278115,2056472,55092
2021,03.27,12936,2291051,2064479,55235
2021,03.28,10338,2301389,2072228,55368
2021,03.29,7208,2308597,2079515,55449
2021,03.30,14014,2322611,2088256,55611
2021,03.31,10154,2332765,2095853,55736
2021,04.01,16056,2348821,2102616,55858
2021,04.02,14430,2363251,2112266,55941
2021,04.03,9902,2373153,2121954,56023
2021,04.04,10384,2383537,2130640,56106
2021,04.05,9955,2393492,2140480,56199
2021,04.06,13667,2407159,2153509,56471
2021,04.07,20870,2428029,2164045,56634
2021,04.08,22039,2450068,2174625,56832
2021,04.09,23683,2473751,2188983,57122
2021,04.10,24130,2497881,2203926,57350
2021,04.11,19419,2517300,2217783,57647
2021,04.12,15262,2532562,2233140,57779
2021,04.13,19437,2551999,2247124,57957
2021,04.14,27001,2579000,2262875,58174
2021,04.15,25157,2604157,2278486,58542
2021,04.16,24999,2629156,2300232,58925
2021,04.17,29472,2658628,2324107,59084
2021,04.18,19119,2677747,2343808,59164
2021,04.19,16267,2694014,2364171,59228
2021,04.20,20461,2714475,2386383,59476
2021,04.21,29145,2743620,2407853,59792
2021,04.22,25932,2769552,2424675,60083
2021,04.23,27216,2796768,2449793,60620
2021,04.24,27884,2824652,2474514,61176
2021,04.25,21220,2845872,2496277,61474
2021,04.26,15012,2860884,2518167,61644
2021,04.27,18793,2879677,2542004,62087
2021,04.28,25495,2905172,2563223,62599
2021,04.29,23718,2928890,2582164,62947
2021,04.30,26053,2954943,2608077,63508
2021,05.01,22420,2977363,2634306,63865
2021,05.02,16502,2993865,2655359,64096
2021,05.03,11394,3005259,2676197,64252
2021,05.04,15920,3021179,2698072,64792
2021,05.05,26238,3047417,2717458,65202
2021,05.06,24079,3071496,2734465,65865
2021,05.07,24086,3095582,2757230,66263
2021,05.08,22552,3118134,2777902,66872
2021,05.09,18024,3136158,2798328,67042
2021,05.10,11582,3147740,2817165,67325
2021,05.11,17381,3165121,2837058,67821
2021,05.12,25976,3191097,2854364,68311
2021,05.13,24475,3215572,2869341,68807
2021,05.14,26531,3242103,2891435,69254
2021,05.15,27363,3269466,2913144,69853
2021,05.16,21469,3290935,2933946,70253
2021,05.17,16350,3307285,2952599,70522
2021,05.18,28680,3335965,2973267,71027
2021,05.19,35543,3371508,2992325,71771
2021,05.20,39652,3411160,3009150,72265
2021,05.21,35884,3447044,3035134,72699
2021,05.22,35468,3482512,3060145,73391
2021,05.23,32171,3514683,3083298,73688
2021,05.24,24801,3539484,3106949,74063
2021,05.25,22651,3562135,3133183,74480
2021,05.26,24601,3586736,3157660,75056
2021,05.27,35399,3622135,3181288,75588
2021,05.28,41080,3663215,3219474,76135
2021,05.29,39207,3702422,3252843,76693
2021,05.30,29841,3732263,3288467,77108
2021,05.31,21346,3753609,3319068,77456
2021,06.01,28175,3781784,3350602,78093
2021,06.02,35355,3817139,3381337,78733
2021,06.03,35017,3852156,3409316,79320
2021,06.04,32291,3884447,3438437,79873
2021,06.05,30950,3915397,3465137,80411
2021,06.06,23627,3939024,3497500,80867
2021,06.07,16415,3955439,3529033,81214
2021,06.08,22195,3977634,3560148,81946
2021,06.09,31137,4008771,3585811,82667
2021,06.10,29757,4038528,3608895,83272
2021,06.11,27628,4066156,3639402,83941
2021,06.12,26934,4093090,3668672,84628
2021,06.13,18057,4111147,3695288,85075
2021,06.14,13043,4124190,3721350,85343
2021,06.15,21292,4145482,3748794,86029
2021,06.16,27260,4172742,3771968,86615
2021,06.17,25878,4198620,3791979,87261
2021,06.18,23780,4222400,3818346,87789
2021,06.19,20363,4242763,3844329,88247
2021,06.20,15631,4258394,3868105,88742
2021,06.21,10395,4268789,3890213,89043
2021,06.22,8606,4277395,3910835,89490
2021,06.23,21387,4298782,3928389,90281
2021,06.24,27319,4326101,3944323,90986
2021,06.25,24463,4350564,3967633,91438
2021,06.26,24023,4374587,3990289,91979
2021,06.27,18555,4393142,4010346,92317
2021,06.28,12105,4405247,4027510,92568
2021,06.29,18389,4423636,4046308,93142
2021,06.30,24065,4447701,4062245,93668
2021,07.01,22673,4470374,4076921,94304
2021,07.02,21177,4491551,4092053,94772
2021,07.03,20888,4512439,4114096,95382
2021,07.04,14034,4526473,4136824,95594
2021,07.05,9000,4535473,4156006,95904
2021,07.06,17277,4552750,4175856,96521
2021,07.07,21590,4574340,4192546,96983
2021,07.08,19423,4593763,4206478,97439
2021,07.09,19256,4613019,4226694,97904
2021,07.10,14518,4627537,4246200,98148
2021,07.11,11561,4639098,4264937,98501
2021,07.12,8850,4647948,4282904,98781
2021,07.13,14989,4662937,4300823,99255
2021,07.14,20023,4682960,4314593,99640
2021,07.15,19697,4702657,4326403,100250
2021,07.16,17295,4719952,4345549,100695
2021,07.17,17261,4737213,4363105,101158
2021,07.18,12230,4749443,4379169,101434
2021,07.19,6935,4756378,4394695,101549
2021,07.20,12764,4769142,4407815,101955
2021,07.21,15077,4784219,4420995,102381
2021,07.22,14632,4798851,4431871,102818
2021,07.23,13500,4812351,4447953,103074
2021,07.24,15622,4827973,4464987,103359
2021,07.25,11136,4839109,4480336,103584
2021,07.26,7506,4846615,4493984,103721
2021,07.27,12555,4859170,4508137,104105
2021,07.28,16757,4875927,4519922,104352
2021,07.29,15883,4891810,4529259,104822
2021,07.30,14115,4905925,4542904,105113
2021,07.31,13483,4919408,4557037,105586
2021,08.01,10356,4929764,4569552,105721
2021,08.02,6083,4935847,4581132,105772
2021,08.03,11183,4947030,4594873,106045
2021,08.04,14850,4961880,4606026,106447
2021,08.05,13736,4975616,4615834,106747
2021,08.06,13786,4989402,4615834,107023
2021,08.07,0,4989402,4615834,107023
2021,08.08,13549,5002951,4615834,107213
2021,08.09,15944,5018895,4615834,107459
2021,08.10,10180,5029075,4615834,107961
2021,08.11,12412,5041487,4615834,108165
2021,08.12,11397,5052884,4615834,108388
2021,08.13,13369,5066253,4615834,108569
2021,08.14,8472,5074725,4615834,108815
2021,08.15,6183,5080908,4615834,108936
2021,08.16,3727,5084635,4615834,109041
2021,08.17,3636,5088271,4615834,109105
2021,08.18,8172,5096443,4615834,109405
2021,08.19,9764,5106207,4615834,109652
2021,08.20,10596,5116803,4615834,109841
2021,08.21,8160,5124963,4615834,110070
2021,08.22,5889,5130852,4615834,110217
2021,08.23,2979,5133831,4615834,110352
2021,08.24,6135,5139966,4615834,110609
2021,08.25,8119,5148085,4615834,110806
2021,08.26,6994,5155079,4615834,110966
2021,08.27,6847,5161926,4615834,111117
2021,08.28,5807,5167733,4615834,111270
